............................................==..................................................................................................................................................................................................................................................................................................................................................................................................................................
.......................................==................................===....................................................................................................................................................................................................................................................................................................................................................................................###############.
.................................................###...===......................................................................................................................................................................................................................................................................................................................................................................................................###############.
.........................................===.....###..........===...............................................................................................................................................................................................................................................................................................................................................................................................###############.
.................................................###....................===..................................................................................................................##############....====.............................................................................................................................................................................................................................................###############.
...............................................#####.........................................................................................................................................##############..........................==................==.......................................................................................................................................................................................................###############.
...............................................#####........===........==..................................................................................................................################.............====...===................==...............................................................................................................................................###..................................##......................###############.
...........................................#########................................................................................................................................#######################..................................................====..................................................................................................................................###..........##.............###......##......................###############.
............1..1............####....####.......#####...........................................................................####..........................................##############################.........................==......====...==..................................................................#######################...............................................##################################################################################.
............................####....####.......#####..............==.........................................................######..................................######################################...........................................................#######################...##############################################........########.............................####################################################################################.
....##...#-----###....##########....####.......#####...................==........................#####..##...##...##...##....######........##........................######################################.............................####..........................#######################...###########################################################################..............######################################################################################.
.##########...####....##########....####.......#####............................###--------###########..##...##...##...##....######################..#####------###########################################.............................####..........................#######################...###############################################################################################################################################################################.
.##########...####....##########....####.......#####..........................######......############..##...##...##...##....##############################....############################################.............................####..........................#######################...###############################################################################################################################################################################.
.##########...####....##########....####......................................######......############..##...##...##...##....##############################....############################################.............................####..........................#######################...###############################################################################################################################################################################.
.##########...####....##########....####......................................######......############..##...##...##...##....##############################....############################################.............................####..........................#######################...###############################################################################################################################################################################.
.##########...####....##########....####......................................######......############..##...##...##...##......................................############################################.............................####..........................#######################...###############################################################################################################################################################################.
.##########...####....##########....####......................................######......############..##...##...##...##..|...................................############################################.............................####..........................#######################...###############################################################################################################################################################################.
###########...####....##########....####......................................######......############..##...##...##...####################################################################################.............................####..........................#######################...###############################################################################################################################################################################.
###########...####....##########....####......................................######......############..##...##...##...####################################################################################.............................####..........................#######################...###############################################################################################################################################################################.
###########...####....##########....####......................................######......############..##...##...##...####################################################################################.............................####..........................#######################...###############################################################################################################################################################################.
###########...####....##########....####......................................######......############..##...##...##...####################################################################################.............................####..........................#######################...###############################################################################################################################################################################.
................................................................................................................................................................................................................................................................................................................................................................................................................................................................................
