............................................==.............................................................................|.................................................................................................................................................................................................................................................................................................................
.......................................==................................===...............................................|.................................................................................................................................................................................................................................................................................................................
.................................................###...===.................................................................|.................................................................................................................................................................................................................................................................................................................
.........................................===.....###..........===..........................................................|.................................................................................................................................................................................................................................................................................................................
.................................................###....................===................................................|.................................................................##############....====..........................................................................................................................................................................................................................
...............................................#####.......................................................................|.................................................................##############..........................==................==....................................................................................................................................................................................
...............................................#####........===........==..................................................|...............................................................################.............====...===................==.........................................................................................................................................................................................
...........................................#########.......................................................................|........................................................#######################..................................................====............................................................................................................................................................................
............................####....####.......#####.......................................................................|...####..........................................##############################.........................==......====...==........................................................................................................................................................................................
............................####....####.......#####..............==.......................................................|.######..................................######################################...........................................................#######################................................................................................................................................................
....##...#-----###....##########....####.......#####...................==........................#####..##...##...##...##..|.######........##........................######################################.............................####..........................#######################................................................................................................................................................
.##########...####....##########....####.......#####............................###--------###########..##...##...##...##..|.######################..#####------###########################################.............................####..........................#######################................................................................................................................................................
.##########...####....##########....####.......#####..........................######......############..##...##...##...##..|.##############################....############################################.............................####..........................#######################................................................................................................................................................
.##########...####....##########....####......................................######......############..##...##...##...##..|.##############################....############################################.............................####..........................#######################................................................................................................................................................
.##########...####....##########....####......................................######......############..##...##...##...##..|.##############################....############################################.............................####..........................#######################................................................................................................................................................
.##########...####....##########....####...................................................................................|...................................############################################.............................####..........................#######################................................................................................................................................................
.##########...####....##########....####...................................................................................|...................................############################################.............................####..........................#######################................................................................................................................................................
###########################################################################################################################################################################################################.............................####..........................#######################................................................................................................................................................
###########################################################################################################################################################################################################.............................####..........................#######################................................................................................................................................................
###########################################################################################################################################################################################################.............................####..........................#######################................................................................................................................................................
###########################################################################################################################################################################################################.............................####..........................#######################................................................................................................................................................
.............................................................................................................................................................................................................................................................................................................................................................................................................................................
