............................................==..................................................................................................................................................................................................................................................................................................................................................................................................................................
.......................................==.........2......................===....................................................................................................................................................................................................................................................................................................................................................................................###############.
.................................................###...===.....2................................................................................................................................................................................................................................................................................................................................................................................................###############.
.........................................===.....###..........===........2......................................................................................................................2...3...2.......................................................................................................................................................................................................................................................###############.
.................................................###....................===..................................................................................................................##############....====.............................................................................................................................................................................................................................................###############.
...............................................#####.........................................................................................................................................##############.....................2....==................==...........................................................................................................................................2...................................4.......................###############.
............................................2..#####........===........==............................................................................................................1...1.################.............====...===................==..........2....................................................................................................................................###..........4...............2.......##......................###############.
.............................2.......2.....#########............................................................................2..............................................1.1..#######################..................................................====..........................................................2....2....2.........................................................11..###..1.5.1...##...1.5..1.1..###......##...5.5.5.5..........f.###############.
............1..1............####....####.......#####...........................................................................####...................................2......##############################.........................==......====...==.....................1...1....1...1............3...3....4.........#######################...........2...................................##################################################################################.
............................####....####.......#####..............==...............................3...................4.....######..................................######################################..............................2............................#######################...##############################################..3..3..########..1.1.1.1.1..................####################################################################################.
....##...#-----###....##########....####.......#####...................==............1.1.1.1.....#####..##...##...##...##....######..3..3..##...............5........######################################.............................####..........................#######################...###########################################################################..1.1.1.1.1...######################################################################################.
.##########...####....##########....####.......#####............................###--------###########..##...##...##...##....######################..#####------###########################################.............................####..........................#######################...###############################################################################################################################################################################.
.##########...####....##########....####.......#####..........................######......############..##...##...##...##....##############################....############################################.............................####..........................#######################...###############################################################################################################################################################################.
.##########...####....##########....####......................................######......############..##...##...##...##....##############################....############################################.............................####..........................#######################...###############################################################################################################################################################################.
.##########...####....##########....####......................................######......############..##...##...##...##....##############################....############################################.............................####..........................#######################...###############################################################################################################################################################################.
.##########...####....##########....####......................................######......############..##...##...##...##......................................############################################.............................####..........................#######################...###############################################################################################################################################################################.
.##########...####....##########....####......................................######......############..##...##...##...##..|...................................############################################.............................####..........................#######################...###############################################################################################################################################################################.
###########...####....##########....####......................................######......############..##...##...##...####################################################################################.............................####..........................#######################...###############################################################################################################################################################################.
###########...####....##########....####......................................######......############..##...##...##...####################################################################################.............................####..........................#######################...###############################################################################################################################################################################.
###########...####....##########....####......................................######......############..##...##...##...####################################################################################.............................####..........................#######################...###############################################################################################################################################################################.
###########...####....##########....####......................................######......############..##...##...##...####################################################################################.............................####..........................#######################...###############################################################################################################################################################################.
................................................................................................................................................................................................................................................................................................................................................................................................................................................................................
