............................................==.................................................................................
.......................................==................................===...................................................
.................................................###...===.....................................................................
.........................................===.....###..........===..............................................................
.................................................###....................===....................................................
...............................................#####...........................................................................
...............................................#####........===........==......................................................
...........................................#########...........................................................................
............................####....####.......#####...........................................................................
............................####....####.......#####..............==...........................................................
....##...#-----###....##########....####.......#####...................==.....................................................
.##########...####....##########....####.......#####..........................###..............................................
.##########...####....##########....####.......#####..........................###..............................................
.##########...####....##########....####.......................................................................................
.##########...####....##########....####.......................................................................................
.##########...####....##########....####.......................................................................................
.##########...####....##########....####.......................................................................................
...............................................................................................................................
