............................................==......................................................................................................................................................................................................................................................
.......................................==................................===........................................................................................................................................................................................................................
.................................................###...===..........................................................................................................................................................................................................................................
.........................................===.....###..........===...................................................................................................................................................................................................................................
.................................................###....................===................................................................................................................##############....====...................................................................................
...............................................#####.......................................................................................................................................##############..........................==................==.............................................
...............................................#####........===........==................................................................................................................################.............====...===................==..................................................
...........................................#########..............................................................................................................................#######################..................................................====.....................................
............................####....####.......#####.........................................................................####..........................................##############################.........................==......====...==.................................................
............................####....####.......#####..............==.......................................................######..................................######################################...........................................................#######################.........
....##...#-----###....##########....####.......#####...................==........................#####..##...##...##...##..######........##........................######################################.............................####..........................#######################.........
.##########...####....##########....####.......#####..........................#####--------###########..##...##...##...##..######################..#####------###########################################.............................####..........................#######################.........
.##########...####....##########....####.......#####..........................######......############..##...##...##...##..##############################....############################################.............................####..........................#######################.........
.##########...####....##########....####......................................######......############..##...##...##...##..##############################....############################################.............................####..........................#######################.........
.##########...####....##########....####......................................######......############..##...##...##...##..##############################....############################################.............................####..........................#######################.........
.##########...####....##########....####.....................................................................................................................############################################.............................####..........................#######################.........
.##########...####....##########....####.....................................................................................................................############################################.............................####..........................#######################.........
....................................................................................................................................................................................................................................................................................................
