..............................
..............................
..............................
..............................
..............................
....##..........tt............
....##...#-----####...........
.##########...#####...........
.##########...#####...........
.##########...#####...........
.##########...#####...........
..............#####...........
..............................